at first	처음에는    0
castle	성   0
consider	고려하다, 간주하다  0
considerable	상당한 0
enlighten	계몽시키다 개화시키다 0
explain	설명하다    0
explanation	설명  0
female	여성의 0
frankly speaking	솔직히 말하여 0
illegal	불법적인    0
in the first place	처음으로    0
in the place of	～대신에    0
intelligent	지적인 0
invent	발명하다, 만들다   0
invention	발명  0
last	마지막, 지난 계속하다    0
lately	최근에 0
law	법   0
oppression	억압  0
press	누르다, 언론, 출판 0
recently	최근에 0
region	지역  0
regional	지역적인    0
reinforce	강화시키다   0
statement	진술  0
suppress	저하시키다   0
suppression	저하, 의기소침    0
symbol	상징, 징표  0
training	훈련  0
universally	보편적으로, 일반적으로    0
consideration	고려, 생각  0
considering that	～을 고려하건대    0
education	교육  0
educational	교육적인    0
endow	부여하다, 기부하다  0
endowment	기부, 기증  0
inherit	상속하다, 이어받다  0
inheritance	유전, 유산  0
instead of	～대신에    0
intelligence	지식  0
lawful	법적인 0
legal	합법적인    0
male	남성의 0
nowadays	최근에 0
of late	최근에 0
oppress	억압하다    0
religion	종교  0
religious	종교적인    0
rib	갈비뼈 0
sociable	사교적인    0
social	사회적인    0
socialize	사회화하다   0
society	사회  0
state	상태, 진술하다    0
symbolic	상징적인    0
these days	최근에 0
train	기차, 훈련시키다   0
trainer	훈련자 0
universal	우주의, 일반적인   0
